1111111111
1C000000C1
100C000001
1P000C00E1
1111111111