11111111111111111111111111111111111111111111
1C0000CCCC000000000C000000C11111110000000C11
1000101000000001C001100001000000000000000111
100010100100000100011C0001000000011100001101
1P001E100000000CCC01000C000011C11CCCC11C0001
1C0000CCCC010000000C000000011111110000000C11
1000101000000001C001100001000000000000000111
1C0000C1CC010100000C0000100110C1110000000011
1000101000010011C001100001000000000000100001
11111111111111111111111111111111111111111111