111111112
1000000E2
1C00000C2
1P0000C12
111111112